rows 30
cols 30
players 2
m ..........%................%..
m ...........................%%.
m %.%...........................
m %.%...........................
m %.....%.%%................%...
m %%%%....%%%..........%........
m %%%.....%%%%........%%%.......
m %.....%..%%%.......%%.%......%
m ..............................
m .%%................%..........
m .%%.................%.........
m ..%%..%........%..............
m ............%........%........
m .................%............
m ...a.......%%.................
m ............%............%....
m ............%%................
m ...............%.%............
m ...............%.%............
m ...........%...%.....%.%%.....
m ......%........%%%%....%%%....
m .....%%%.......%%%.....%%%%...
m ....%%.%......%%.....%..%%%...
m ..............................
m ....%...........%%............
m .....%..........%%............
m %................%%..%........
m ......%....................%..
m ..%...........................
m ..................b.......%%..
