rows  100
cols  100
players 1
m %%%%%%%%%%%%%%%%%%%%%%%%%%%%%%%%%%%%%%%%%%%%%%%%%%%%%%%%%%%%%%%%%%%%%%%%%%%%%%%%%%%%%%%%%%%%%%%%%%%%
m a..%...........%.........%.%.......%.....%.....%...........%.....%...%.......%...............%.....%
m %%.%.%%%%%%%%%.%.%%%.%%%.%.%.%.%.%%%.%.%%%.%.%%%.%%%%%.%%%.%.%%%.%.%.%.%%%%%.%%%%%%%%%.%.%%%.%.%%%.%
m ...%.........%.%.%...%...%...%.%.%...%.....%.......%...%.%...%.%.%.%...%...%...%.....%.%.%.%.%...%.%
m .%%%%%%%%%%%.%%%.%.%%%.%%%.%%%.%%%.%%%%%%%%%.%%%%%%%.%%%.%%%%%.%.%.%%%%%.%%%%%.%.%%%.%%%.%.%.%.%%%.%
m .....%.....%.....%.%.%.%.....%.....%.......%.....%...%.%...%.....%.%.....%.....%...%.....%...%.%...%
m %%%%.%.%%%.%%%.%%%.%.%.%%%%%.%%%%%%%.%%%%%.%%%%%.%.%%%.%.%.%.%%%%%.%.%%%.%.%%%%%%%.%%%%%%%.%%%%%.%.%
m ...%.%.%.%...%.%...%.%.....%.....%...%.....%.....%.%...%.%.%.......%...%.%...%...%...%.%.......%.%.%
m .%%%.%.%.%%%.%%%.%%%.%%%%%.%%%%%%%.%%%.%%%%%%%.%%%.%%%.%.%.%%%%%%%%%%%.%.%%%.%.%.%%%.%.%.%%%%%.%.%.%
m .%...%.%...%.....%.......%.......%.%.....%...%...%...%.%.%.............%...%.%.%.....%.%.%...%...%.%
m .%.%%%.%.%.%%%%%%%%%%%.%%%%%%%%%.%.%%%%%.%.%.%%%%%%%.%.%.%%%.%%%%%%%.%%%%%.%.%.%%%%%%%.%.%.%.%%%%%.%
m .%.%...%.%.....%.......%.......%.%...%.%...%.......%.%...%...%.......%...%.%.%.......%...%.%...%...%
m .%.%%%.%.%%%%%.%.%%%%%.%.%%%.%%%.%%%.%.%%%%%%%%%%%.%.%%%.%.%%%.%%%%%%%.%.%.%.%%%%%%%.%%%%%.%%%.%%%.%
m .%.....%.%.%...%.%.....%.%.%.%...%...%.......%.....%...%.%.%.........%.%.%.%.....%...%.......%...%.%
m .%%%%%%%.%.%.%%%.%%%%%%%.%.%.%.%%%.%%%%%%%.%.%.%%%%%%%.%%%.%.%%%%%%%%%.%.%%%%%%%.%.%%%.%%%%%%%%%.%.%
m .....%...%.%...%...%...%...%...%...%...%...%.%.%.......%...%.%.%.......%.........%...%.%.....%...%.%
m .%%%.%%%.%.%%%.%%%.%.%.%%%.%%%%%.%%%.%.%.%%%.%.%%%.%%%%%.%%%.%.%.%%%%%%%%%%%%%%%%%.%.%.%.%%%.%.%%%%%
m ...%.....%...%.....%.%.....%.....%...%...%...%.....%...%...%...%.%...%.....%...%...%...%.%.....%...%
m .%.%%%%%%%%%.%%%%%.%.%%%%%%%.%%%%%.%.%%%%%%%%%%%%%%%.%%%.%.%%%%%.%.%.%.%.%.%.%.%.%%%%%%%.%%%%%%%.%.%
m .%.........%.....%.%.%...%...%...%.%.%.........%...%.....%.......%.%...%.%.%.%.%.%.....%.........%.%
m .%%%%%%%%%.%.%%%%%.%.%.%.%.%%%.%%%.%.%.%%%%%.%%%.%.%.%%%%%%%%%%%%%%%%%%%.%.%.%%%.%%%%%.%%%%%%%%%.%.%
m ...%.%.....%.....%.%...%...%...%...%.%...%.%.%...%...%...%...........%...%.%...%.%.........%...%.%.%
m %%.%.%.%%%%%%%%%.%.%%%%%%%%%.%.%.%%%.%%%.%.%.%.%%%%%%%.%%%.%%%.%%%%%.%.%%%.%%%.%.%.%%%%%.%%%.%.%%%.%
m .....%.%.........%.....%.....%.%.%.%...%...%...%.%.......%...%...%.....%.%.%...%...%.%...%...%...%.%
m .%%%%%.%.%.%%%%%%%%%%%.%.%%%%%%%.%.%%%.%%%.%%%%%.%.%%%%%.%%%.%%%.%%%%%%%.%.%.%%%%%%%.%.%%%.%%%%%.%.%
m .%.%...%.%...%.......%...%.....%...%.%...%...%...%.%.......%...%.%.....%.....%.......%.%.%.%.....%.%
m .%.%.%%%.%%%.%.%.%%%%%.%%%.%%%.%%%.%.%%%.%%%.%.%.%.%.%%%%%.%%%.%.%.%%%.%%%%%%%.%%%.%%%.%.%.%.%%%%%.%
m .%.%...%...%...%.......%...%.....%...%.%.....%.%.%.%...%.....%.%.%.%.%...%.....%.%.....%.%.%...%...%
m .%.%%%.%%%.%%%%%%%%%%%%%.%%%.%%%.%%%.%.%%%%%%%%%.%.%%%.%%%%%%%.%.%.%.%%%.%.%%%%%.%%%%%%%.%.%%%.%.%.%
m .%.%...%...%...........%...%.%...%.%...%...%.....%...%.........%...%.%...%.......%...%...%.%.%.%.%.%
m .%.%.%%%%%.%%%%%%%%%%%.%%%.%.%.%%%.%%%.%.%.%.%.%%%%%.%%%%%%%%%%%%%%%.%.%%%%%%%%%.%.%.%%%.%.%.%.%.%%%
m .%.%.%...%.....%.........%.%.%.......%.%.%.%.%...%...%.....%.........%...........%.%...%.%.%.%.%...%
m .%.%.%.%.%%%%%.%.%%%%%.%%%.%.%%%%%%%.%.%.%.%.%%%.%.%%%.%%%.%.%%%.%%%.%%%%%%%%%%%%%.%%%.%.%.%.%.%.%.%
m ...%...%.%...%...%.....%...%.%...%.%.%.%.%.....%...%...%.%.%...%.%.%.%...%.......%...%...%.%...%.%.%
m %%.%%%%%.%.%.%%%%%.%%%%%.%%%.%.%.%.%.%.%%%%%%%%%.%%%.%%%.%.%%%.%.%.%.%.%.%.%%%%%.%%%.%%%.%.%.%%%%%.%
m .%.....%.%.%.........%...%.%...%.%...%.........%...%...%.%.%...%.%.%.%.%...%...%...%...%.%.%.......%
m .%%%%%.%.%.%%%%%%%%%%%.%%%.%%%%%.%%%%%%%%%%%%%.%%%.%%%.%.%.%.%%%.%.%.%.%%%%%%%.%%%.%%%.%.%.%%%%%%%.%
m ...%...%.%.%...%...%...%...%...%...........%...%.......%...%...%.%.%...%.........%.%...%.%.%...%...%
m .%.%.%%%.%.%.%%%.%.%.%%%.%.%%%.%%%%%%%%%.%%%.%%%%%%%%%%%.%%%%%%%.%.%%%%%.%.%%%%%.%.%.%.%%%.%.%.%.%%%
m .%.%.%...%.%.%...%...%...%.....%.......%...%.......%.....%.......%.......%.%...%.%...%.%...%.%.%...%
m %%.%.%.%%%.%.%.%%%%%%%%%.%%%%%%%.%%%.%%%%%.%%%%%%%.%.%%%%%%%.%%%%%.%%%%%%%.%.%.%.%%%.%%%.%%%.%.%%%.%
m ...%.%.%...%.%.%.%.......%.......%...%...........%.%.........%.....%.......%.%.%.%...%...%...%.%...%
m .%%%.%.%.%%%.%.%.%.%.%%%.%.%%%%%%%.%%%.%%%%%%%%%.%.%%%%%%%%%%%.%%%%%.%%%%%%%.%%%.%.%%%.%.%.%%%.%%%%%
m ...%.%.%.....%.%...%...%.%.%.%...%.%...%.......%.%.%.........%.%.....%.%...%.....%...%.%.%...%.....%
m .%.%.%.%%%%%%%.%%%.%%%.%%%.%.%.%.%.%.%.%.%%%%%.%%%.%.%%%%%%%.%%%.%%%%%.%.%.%.%%%%%.%%%.%.%%%.%%%%%.%
m .%.%.%...%...%...%...%.....%.%.%...%.%.%.%...%...%.%.....%.......%.%.....%.....%...%...%...%.....%.%
m .%.%.%%%.%.%.%%%.%%%.%%%%%%%.%.%%%.%.%%%.%.%.%%%.%.%.%%%.%%%%%%%%%.%.%%%%%%%.%%%.%%%.%%%%%%%%%.%%%.%
m .%...%.%...%...%.%.%.....%...%...%.%...%...%.%.%...%...%.%...%.......%.....%.%.....%.%...%.....%...%
m .%%%%%.%%%%%.%%%.%.%%%%%.%%%.%%%.%%%%%.%%%%%.%.%%%%%.%%%.%.%.%%%%%%%%%.%%%.%.%.%%%%%.%.%.%.%%%%%.%.%
m ...%.......%...%.%.....%.......%.....%.....%...%...%.%...%.%...%.....%.%...%.%.%.....%.%...%.....%.%
m %%.%%%%%.%.%%%.%.%.%.%%%%%%%.%%%%%%%.%.%%%%%%%.%.%%%.%.%.%.%%%.%.%%%.%.%.%%%%%.%.%%%%%.%%%%%.%%%%%.%
m .%.......%.%...%.%.%.....%...%.....%.%.......%.%.....%.%.%...%.%.%.%...%.......%.......%.....%.....%
m .%%%%%%%%%.%.%%%.%%%%%%%.%.%%%.%%%.%.%%%%%%%.%.%.%%%%%.%%%%%.%.%.%.%%%%%%%%%%%%%.%%%%%%%.%%%%%.%%%%%
m ...........%...%.......%.....%.%...%...%...%.%.%.....%.....%.%.%...%.......%...%.%.....%...%.......%
m .%%%%%%%%%%%%%.%%%%%%%.%%%%%%%.%.%%%.%.%.%.%.%.%%%%%%%%%%%.%.%.%%%.%.%%%%%.%.%.%.%%%%%.%%%.%%%%%%%.%
m .%.......%.......%...%.......%.%.%...%.%.%...%.....%.....%.%.%...%.%.%.....%.%.%.........%.%.....%.%
m .%.%%%%%.%.%%%%%.%%%.%%%%%%%.%.%.%.%%%.%.%%%%%%%%%.%.%%%.%.%.%%%.%.%%%.%.%%%.%.%%%%%%%%%%%.%.%%%.%.%
m .%.%.....%.....%...%.....%.%.%.%.%.%...%.........%...%.%.%...%.%.%...%.%.%...%.%.....%...%.....%.%.%
m .%%%.%%%%%%%.%.%%%.%.%%%.%.%.%.%.%.%.%%%%%%%%%.%%%%%%%.%.%.%%%.%.%%%.%.%.%.%%%.%.%%%.%.%.%%%%%%%.%.%
m .....%.....%.%.%.%.%.%.%...%...%.%.%.%.......%.........%.%.....%.......%.%.%...%.%.%...%.%.....%.%.%
m %%%%%%.%%%.%%%.%.%.%.%.%.%%%%%%%.%.%.%%%%%%%.%%%%%.%%%.%.%%%%%.%%%%%%%.%%%.%.%%%.%.%%%%%.%.%%%.%.%%%
m .....%...%...%.%.....%...%.....%...%.%.....%.....%.%...%.%.....%...%...%...%...%.%...%...%.%...%...%
m .%%%.%.%.%%%.%.%%%%%%%.%%%.%.%.%%%%%.%.%%%.%.%%%.%.%%%%%.%.%%%%%.%.%%%%%.%%%%%.%.%.%.%.%%%.%.%%%%%.%
m .%.%.%.%.%.%...%...%...%...%.%...%.%...%.%.%.%.%.%.......%...%...%.....%.....%...%.%.%.....%.....%.%
m .%.%.%%%.%.%%%.%.%.%%%%%.%%%.%%%.%.%%%%%.%.%.%.%.%%%%%%%%%.%%%.%%%%%%%.%.%%%.%%%%%.%%%%%%%%%%%%%.%.%
m .%.%...%.%...%.%.%.........%.%.....%.....%.%.%...%.........%...%.....%.%.%...%...%.....%.........%.%
m .%.%%%.%.%.%.%.%.%%%%%%%%%%%.%%%%%.%%%.%.%.%.%%%.%%%%%%%%%.%.%%%%%%%.%.%%%.%%%.%.%.%%%.%.%%%%%%%%%.%
m .%...%...%.%.%.%...%...%...%...%.%...%.%.%.%...%.........%.%.%.....%.%...%...%.%.....%.%.%.........%
m .%.%%%%%%%%%.%.%%%.%%%.%.%.%%%.%.%%%.%.%%%.%%%.%%%%%%%%%.%%%.%%%.%.%.%%%.%%%.%.%%%%%%%.%.%%%.%%%%%.%
m .%.........%.%...%.%...%.%.%...%...%...%...%...%.....%...%...%...%...%.%.....%.%.%.....%.....%.%...%
m .%.%%%.%%%.%.%%%.%.%.%%%.%.%.%%%.%.%.%%%.%%%.%%%%%%%.%.%%%.%%%.%%%%%.%.%%%%%%%.%.%.%%%.%%%%%%%.%.%%%
m .%...%.%.......%.%.%.%...%...%.%.%...%...%.........%.%.....%...%.%.......%.....%.%...%.........%...%
m .%.%%%.%%%%%%%%%.%.%.%.%%%%%%%.%.%%%%%.%%%%%.%%%%%.%.%%%%%%%%%.%.%.%%%%%%%.%%%%%.%%%.%%%%%%%%%.%%%.%
m .%.%...%.........%.%.%.....%...%.%.%...%...%...%...%...........%.%.%...%...%.....%...%...........%.%
m .%.%.%%%.%%%%%%%.%.%.%%%%%.%.%.%.%.%.%%%.%.%%%%%.%%%%%%%.%%%%%%%.%.%.%.%.%%%.%.%.%.%%%.%%%%%%%%%%%.%
m .%.%.....%.....%.%.%.....%.%.%.....%.....%.%...%.%.......%.........%.%...%...%.%.%...%...%.........%
m .%%%.%%%%%.%%%.%%%.%.%%%.%.%%%%%%%%%%%%%%%.%.%.%.%%%.%.%%%%%%%.%%%%%.%%%%%%%%%.%.%%%.%%%.%.%%%%%%%%%
m ...%.%.....%.%...%.%.%.%.%...%...........%...%...%...%.%.....%.%...%.%.........%.%.%.%.%.%.........%
m .%.%.%.%%%%%.%%%.%.%.%.%.%%%.%.%%%.%%%%%.%%%%%%%%%.%%%.%.%%%.%%%.%.%.%%%%%.%%%%%.%.%.%.%.%%%%%%%%%.%
m .%.%.%.........%.%.%.%.%...%...%.%.%...%...%...%.....%.%...%.%...%...%.....%...%...%.%.%.%.%.....%.%
m .%.%%%%%%%%%.%%%.%.%.%.%.%%%%%%%.%.%.%%%%%.%.%.%.%%%.%.%%%.%.%.%%%%%%%.%%%%%.%.%%%.%.%.%.%.%.%%%.%.%
m .%.......%...%...%.%.%.%.........%.%.......%.%...%.%.%...%.%.%.%.......%.....%.%...%.%.%.%.%...%...%
m .%%%%%.%.%.%%%.%%%.%.%.%%%%%%%.%%%.%.%%%%%%%.%%%%%.%.%%%%%.%.%.%%%%%%%.%.%%%.%%%.%%%.%.%.%.%%%.%%%%%
m .%.....%.%.%.%.....%.%.....%...%...%.%.....%.%.....%.....%.%.%.........%...%.%.....%.%...%...%.%...%
m .%.%%%%%%%.%.%%%%%%%.%.%%%.%.%.%.%%%.%.%.%%%.%.%%%.%%%%%.%.%.%%%%%%%%%%%.%.%%%.%%%%%.%.%%%%%.%.%.%.%
m .%.%.......%...%.....%...%.%.%.%...%...%.%...%...%...%...%.%...%.....%...%.....%.%...%.......%.%.%.%
m .%.%.%%%%%%%.%.%%%.%%%%%.%.%.%%%%%.%%%%%%%.%%%%%%%%%.%.%%%.%%%.%.%%%.%.%%%%%%%%%.%.%%%.%%%%%.%.%.%.%
m .%...%...%...%...%.%.....%.%.....%.%.......%.......%.%.......%.%.%.%...%.........%.%...%...%.%...%.%
m .%%%%%.%.%.%%%%%.%.%%%.%%%.%%%.%.%.%.%%%%%%%.%%%%%.%.%%%%%%%%%.%.%.%%%%%.%%%%%%%%%.%%%%%.%.%.%%%%%.%
m ...%...%...%.....%...%.%...%.%.%.%...%...%.....%.%.%.......%...%.....%...........%...%...%.%.%...%.%
m %%.%%%.%%%%%.%%%%%%%.%.%%%.%.%.%.%%%%%.%.%%%%%.%.%.%%%%%.%%%.%%%%%%%.%.%%%%%%%%%.%%%.%.%%%.%.%.%.%.%
m .%...%.%...%.....%.%.%...%.%.%.%...%...%.......%.%.....%...%.%.......%.......%.....%...%.%.%...%.%.%
m .%%%.%.%.%.%%%%%.%.%.%%%.%.%.%.%%%.%%%.%%%%%%%%%.%%%%%.%%%.%.%.%%%%%%%%%.%%%%%.%%%%%%%%%.%.%%%%%%%.%
m ...%...%.%...%...%...%...%...%...%...%.%.........%.....%...%.%.%.....%...%...%...........%.........%
m .%.%%%%%.%%%%%.%%%.%%%.%%%%%.%%%.%%%.%.%%%%%.%%%.%.%%%%%.%.%.%.%.%%%.%%%%%.%.%.%%%%%%%.%.%%%%%%%%%%%
m .%.......%...%.%.%...%...%...%.%.%.....%.....%...%.%.....%.%.%.%.%.%.......%.%.%.....%.%.%.......%.%
m .%%%%%%%%%.%.%.%.%%%.%%%.%.%%%.%.%%%%%%%.%%%%%.%%%.%.%%%%%%%.%.%.%.%%%%%%%%%.%.%.%%%.%.%%%.%.%%%.%.%
m ...%.......%...%.........%.....%...%.....%.......%.%.....%...%...%.%.....%...%.%.%.%.%.....%.%.%...%
m .%.................................%.%...................%...........%...........%...........%....*%
m %%%%%%%%%%%%%%%%%%%%%%%%%%%%%%%%%%%%%%%%%%%%%%%%%%%%%%%%%%%%%%%%%%%%%%%%%%%%%%%%%%%%%%%%%%%%%%%%%%%%
