rows 50
cols 50
players 2
m a.................................................
m ..................................................
m ..........%.....................%.................
m ..........%....%................%....%............
m ..........%....%................%....%............
m ..........%....%................%....%............
m ........%%.....%................%....%............
m .......%%......%%..............%%....%............
m .....%%%.........%............%%.....%............
m ..%%%%...........%%..........%%......%%...........
m ...................%%%.....%%%........%%..........
m ......................%%%%%%...........%..........
m ........................................%%........
m .........................................%%.......
m ...%%%....................................%%......
m ......%%%................%%.................%.....
m .........%%%............%%..................%%....
m ...........%....%%%%....%........%%%%%%......%....
m ...........%..%%.......%.........%...........%....
m ...........%.%%.......%%........%%...........%....
m ...........%.%.......%..b.......%............%....
m ...........%.%......%%.........%............%%....
m ...........%.%.....%%.....%....%..........%%%.....
m ..........%%.%.....%.....%%....%........%%%%......
m .........%%..%....%......%.....%.......%%.........
m ........%%...%...%%.....%......%.....%%%..........
m ......%%.....%..........%......%..%%%%..........%%
m ....%%%......%.........%........%..............%%.
m ..%%%.........%.......%%.........%.............%..
m ..............%......%%..........%%...........%...
m ..............%......%............%%........%%....
m .............%%.....%..............%.......%......
m .........%...%......%..............%.....%%.......
m .........%..%%.....%%..............%....%%........
m .........%%%%......%...............%..%%..........
m ...................%.....%........%%.%............
m ...................%.....%........%.............%.
m ...................%.....%......%%%.............%.
m ...%%%%%............%....%..%%%%%....%%%%%%%%%%.%.
m .......%%...........%.....%%%........%...%......%.
m ..%%%...%....%%%....%%...............%..........%.
m ..%.%....%......%%%..%%..............%...%.....%%.
m .%...%%..%.......%%...%%.............%.%%%%%%%%%..
m .%.%..%%.%%.....%%.....%%%%..........%..%.....%...
m .%..%..%..%....%%.........%%%%.......%..%.%...%...
m .%..%..%..%...%%.....................%....%.%%%%%.
m .%%..%%...%..%..........%%...........%%%%%%.....%.
m ..%......%%..%.........%%.................%.......
m ..%%%%%%%%...%%%%%%%%%%%..................%%%%%%%.
m ..................................................
