rows 20
cols 20
players 0
m .....a........b.....
m .%%%%..........%%%%.
m .%%%%..%%%%%%..%%%%.
m .%%%%..%%%%%%..%%%%.
m .%%%%..%%%%%%..%%%%.
m .......%%%%%%.......
m ..%%...%%%%%%...%%..
m ..%%...%%%%%%...%%..
m ....................
m ...%%%%%%%.%%%%%%...
m ...%%%%%%%.%%%%%%...
m ...%%%%%%%.%%%%%%...
m ...%%%%%%%.%%%%%%...
m ...%%%%%%%.%%%%%%...
m ....................
m .%%%%..%%..%%..%%%%.
m .%%%%..%%..%%..%%%%.
m .%%%%..........%%%%.
m .%%%%....%%....%%%%.
m .........%%.........
