rows 75
cols 85
play.rs 5
m .....%%%%%%%%%%.....%..............%%%%%%%................%%%%%%.........%......%%...
m ...%.%%%%%%%%%%..%%%%..............%%%%%%%....%..%%%......%%%%%......................
m ......%%%%%%%%%..%%%.................%%%%%....%..%%....%..%%%%%......................
m ......%%%%%%%...%%%......%...........%%%%%%%...........%..%%%%.......................
m ......%%%%......%..%.................%%%%%%%............%.%%%........................
m ....%%%%%%%...%%...%%%..........%.....%%..................%%%%.%%%..............%....
m .....%%%%%....%%....%.%%........%.%...%%..........%.......%%%%%%%%...........%.%.....
m .....%%%.......%...%%....%......%.....%%%%.......%........%..%%%%%%%.................
m ..%%%%%%......%....%%%..%%%%...%%.%....%%.....................%%%%.................%.
m %.%%%%%%%%%.........%%..%%%%%%%%................................%%...........%......%
m %.%%%%%%%%%.......%%%%%%%%%%%%%%............................%....%%%.........%%%.%.%%
m ...%%%%%%%.......%%%%%%%%%%%%%%%.%.%%.............%......%......%...%%%....%..%%%%.%%
m ...%%%%%%.........%.%%%%%%%%%%%%....%....................%%%...%%..%%%.....%..%%%%.%%
m ..%%%%%%............%%%%%%%%%%%%.....%%....%..............%%%%.....%%..%........%...%
m ..%%%%%%...........%.%%%%%%%%%........%..................%%%%%.%....%................
m .%%%%%%%................%%%%%%.........%......%%........%%%%%%%%%%.....%.............
m .%%%%%%%....%..%%%......%%%%%.........................%.%%%%%%%%%%..%%%%.............
m ...%%%%%....%..%%....%..%%%%%............................%%%%%%%%%..%%%..............
m ...%%%%%%%....b......%..%%%%.............................%%%%%%%...%%%......%........
m ...%%%%%%%............%.%%%..............................%%%%......%..%..............
m ....%%..................%%%%.%%%..............%........%%%%%%%...%%...%%%..........%.
m %...%%..........%.......%%%%%%%%...........%.%..........%%%%%....%%....%.%%........%.
m ....%%%%.......%........%..%%%%%%%......................%%%.......%...%%....%......%.
m %....%%.....................%%%%.................%...%%%%%%......%....%%%..%%%%...%%.
m ..............................%%...........%......%%.%%%%%%%%%.........%%..%%%%%%%%..
m ..........................%....%%%.........%%%.%.%%%.%%%%%%%%%.......%%%%%%%%%%%%%%..
m .%%.............%......%......%...%%%....%..%%%%.%%...%%%%%%%.......%%%%%%%%%%%%%%%.%
m ..%....................%%%...%%..%%%.....%..%%%%.%%...%%%%%%.........%.%%%%%%%%%%%%..
m ...%%....%..............%%%%.....%%..%........%...%..%%%%%%............%%%%%%%%%%%%..
m ....%..................%%%%%.%....%..................%%%%%%...........%.%%%%%%%%%....
m .....%......%%........%%%%%%%%%%.....%..............%%%%%%%................%%%%%%....
m ....................%.%%%%%%%%%%..%%%%..............%%%%%%%....%..%%%......%%%%%.....
m .......................%%%%%%%%%..%%%.................%%%%%....%..%%....%..%%%%%.....
m .......................%%%%%%%...%%%......%...........%%%%%%%...........%..%%%%......
m .......................%%%%......%..%.................%%%%%%%............%.%%%.......
m ............%........%%%%%%%...%%...%%%..........%.....%%..................%%%%.%%%..
m .........%.%..........%%%%%....%%....%.%%........%.%...%%..........%.......%%%%%%%%..
m ......................%%%.......%...%%....%......%.....%%%%.......%........%..%%%%%%%
m ...............%...%%%%%%......%....%%%..%%%%...%%.%....%%.....................%%%%..
m .........%......%%.%%%%%%%%%.........%%..%%%%%%%%................................%%..
m .........%%%.%.%%%.%%%%%%%%%.......%%%%%%%%%%%%%%............................%....%%%
m %%%....%..%%%%.%%...%%%%%%%.......%%%%%%%%%%%%%%%.%.%%.............%......%......%...
m %%.....%..%%%%.%%...%%%%%%.........%.%%%%%%%%%%%%....%....................%%%...%%..%
m %..%........%...%..%%%%%%............%%%%%%%%%%%%.....%%....%..............%%%%.....%
m %..................%%%%%%...........%.%%%%%%%%%........%..................%%%%%.%....
m ...%..............%%%%%%%................%%%%%%.........%......%%........%%%%%%%%%%..
m %%%%..............%%%%%%%....%..%%%......%%%%%.........................%.%%%%%%%%%%..
m %%%.................%%%%%....%..%%....%..%%%%%............................%%%%%%%%%..
m %%......%...........%%%%%%%....a......%..%%%%.............................%%%%%%%...%
m ..%.................%%%%%%%............%.%%%..............................%%%%......%
m ..%%%..........%.....%%..................%%%%.%%%..............%........%%%%%%%...%%.
m ...%.%%........%.%...%%..........%.......%%%%%%%%...........%.%..........%%%%%....%%.
m ..%%....%......%.....%%%%.......%........%..%%%%%%%......................%%%.......%.
m ..%%%..%%%%...%%.%....%%.....................%%%%.................%...%%%%%%......%..
m ...%%..%%%%%%%%................................%%...........%......%%.%%%%%%%%%......
m .%%%%%%%%%%%%%%............................%....%%%.........%%%.%.%%%.%%%%%%%%%......
m %%%%%%%%%%%%%%%.%.%%.............%......%......%...%%%....%..%%%%.%%...%%%%%%%.......
m .%.%%%%%%%%%%%%....%....................%%%...%%..%%%.....%..%%%%.%%...%%%%%%........
m ...%%%%%%%%%%%%.....%%....%..............%%%%.....%%..%........%...%..%%%%%%.........
m ..%.%%%%%%%%%........%..................%%%%%.%....%..................%%%%%%.........
m .......%%%%%%.........%......%%........%%%%%%%%%%.....%..............%%%%%%%.........
m %......%%%%%.........................%.%%%%%%%%%%..%%%%..............%%%%%%%....%..%%
m ....%..%%%%%............................%%%%%%%%%..%%%.................%%%%%....%..%%
m ....%..%%%%.............................%%%%%%%...%%%......%...........%%%%%%%.......
m .....%.%%%..............................%%%%......%..%.................%%%%%%%.......
m .......%%%%.%%%..............%........%%%%%%%...%%...%%%..........%.....%%...........
m .......%%%%%%%%...........%.%..........%%%%%....%%....%.%%........%.%...%%..........%
m .......%..%%%%%%%......................%%%.......%...%%....%......%.....%%%%.......%.
m ...........%%%%.................%...%%%%%%......%....%%%..%%%%...%%.%....%%..........
m .............%%...........%......%%.%%%%%%%%%.........%%..%%%%%%%%...................
m .........%....%%%.........%%%.%.%%%.%%%%%%%%%.......%%%%%%%%%%%%%%...................
m ......%......%...%%%....%..%%%%.%%...%%%%%%%.......%%%%%%%%%%%%%%%.%.%%.............%
m ......%%%...%%..%%%.....%..%%%%.%%...%%%%%%.........%.%%%%%%%%%%%%....%..............
m .......%%%%.....%%..%........%...%..%%%%%%............%%%%%%%%%%%%.....%%....%.......
m ......%%%%%.%....%..................%%%%%%...........%.%%%%%%%%%........%............
