rows 20
cols 20
players 0
m ....................
m ....................
m ....................
m ....................
m ....................
m ....................
m %%%%%%%%%%%%%%%%%%%%
m %a.................%
m %.%%%%%%%%%%%%%%%%.%
m %.%%%%%%%%%%%%%%%%.%
m %.%%%%%%%%%%%%%%%%.%
m %.%%%%%%%%%%%%%%%%.%
m %*.................%
m %%%%%%%%%%%%%%%%%%%%
m ....................
m ....................
m ....................
m ....................
m ....................
m ....................
