rows 20
cols 20
players 0
m ....................
m ....................
m ....................
m ......*.............
m ....................
m ....................
m ....................
m ....................
m ....................
m ....................
m ...*....ab....*.....
m ....................
m ....................
m ....................
m ....................
m ....................
m ...*................
m .........*..........
m ....................
m ....................
