rows 20
cols 20
players 1
m %%%%%%%%%%%%%%%%%%%%
m %..................%
m %..................%
m %...a..............%
m %..................%
m %..................%
m %..................%
m %.....%%%%%%%......%
m %.....%%%%%%%......%
m %.....%%b..%%%%%...%
m %.....%%...........%
m %.....%%...........%
m %.....%%%%%%%%%%...%
m %..................%
m %..................%
m %..................%
m %..................%
m %...a..............%
m %..................%
m %%%%%%%%%%%%%%%%%%%%
