rows 20
cols 20
players 1
m %%%%%%%%%%%%%%%%%%%%
m %%%%%%%%%%%%%%%%%%%%
m %%%%%%%%%%%%%%%%%%%%
m %%%%%%%%%%%%%%%%%%%%
m %%%%%%%%%%%%%%%%%%%%
m %%%%%%%..........%%%
m %%%%%%%.%%%%%%%%.%%%
m %%%%%%%.%%%%%%%%.%%%
m %aa.........b....%%%
m %%%%%%%%%%%%%%%%%%%%
m %%%%%%%%%%%%%%%%%%%%
m %%%%%%%%%%%%%%%%%%%%
m %%%%%%%%%%%%%%%%%%%%
m %%%%%%%%%%%%%%%%%%%%
m %%%%%%%%%%%%%%%%%%%%
m %%%%%%%%%%%%%%%%%%%%
m %%%%%%%%%%%%%%%%%%%%
m %%%%%%%%%%%%%%%%%%%%
m %%%%%%%%%%%%%%%%%%%%
m %%%%%%%%%%%%%%%%%%%%
