rows  50
cols  50
players 2
m %%%%%%%%%%%%%%%%%%%%%%%%%%%%%%%%%%%%%%%%%%%%%%%%%%
m a..%.........%.....%.....................%.......%
m %%.%.%%%%%.%%%.%.%.%%%.%%%%%%%%%%%%%%%%%.%.%%%%%.%
m ...%.%...%.%...%.%...%...%.......%.....%.%...%...%
m .%%%%%.%.%.%.%%%.%%%.%%%.%.%.%.%%%.%%%.%.%%%%%.%%%
m .......%.%.....%.%.%...%.%.%.%.%...%.%.%.....%...%
m %%%%%%%%.%.%%%%%.%.%%%.%.%.%.%%%.%%%.%.%%%%%.%.%.%
m .%.....%.%.%.....%...%...%.%.........%...%...%.%.%
m .%.%%%.%.%%%.%%%%%.%.%%%%%%%%%.%%%%%.%%%.%.%%%%%.%
m .%...%...%...%.....%.....%...%.%...%...%.%.%.....%
m .%%%.%%%%%.%%%.%%%%%%%%%.%.%.%%%.%.%%%%%.%.%.%%%.%
m ...%.%...%.%.%...%...%...%.%.....%...%...%...%.%.%
m .%.%.%.%.%.%.%.%.%%%.%.%%%.%%%%%%%%%.%.%%%%%%%.%.%
m .%...%.%.%.%.%.%...%.%.%...%.%.....%.%.......%...%
m .%%%%%.%.%.%.%.%%%.%.%.%.%%%.%.%%%.%.%.%.%%%%%.%%%
m .%.....%...%.%...%.%.....%.%...%.%.%.%.%.....%.%.%
m .%%%.%%%%%%%.%%%.%.%%%%%%%.%.%%%.%.%.%%%%%%%.%.%.%
m .....%.%.........%...%.......%...%.....%.....%...%
m %%%%%%.%.%%%%%%%%%%%.%.%%%%%%%%%.%%%%%.%.%%%.%%%.%
m ...%.....%.........%.%...........%...%...%.%.%.%.%
m .%.%.%%%%%%%%%.%%%.%.%%%%%%%.%%%%%.%.%%%%%.%.%.%.%
m .%.%.%.........%.%.%...%.....%.....%.....%.....%.%
m .%%%.%.%%%%%%%%%.%.%%%.%.%%%%%.%%%%%%%%%.%%%%%%%.%
m ...%.%.%.........%...%.%.%...%.%...%...%.%.......%
m .%.%.%.%.%%%%%.%%%%%.%.%%%.%.%.%.%.%.%.%.%.%%%%%%%
m .%.%.%.%.%...%.....%.%...%.%...%.%.%.%...%.%.%...%
m %%.%.%.%.%.%%%%%%%.%.%%%.%.%%%%%.%.%.%%%%%.%.%.%.%
m ...%...%.%.....%...%.%.%.%.......%.%.%...%.%...%.%
m .%.%%%%%.%%%%%.%.%%%.%.%.%%%%%%%%%.%.%.%.%.%%%%%.%
m .%.%...%...%...%.....%.%.........%.%...%.%.%.....%
m .%.%.%.%%%.%.%%%%%%%%%.%%%%%%%.%%%.%%%%%.%.%.%%%.%
m .%...%...%.%.......%.........%...%.%...%...%.%...%
m .%%%%%%%%%.%.%%%.%.%%%.%.%%%.%%%.%.%.%%%%%%%.%.%%%
m ...%.......%...%.%...%.%...%.%.%.%.%...%.....%...%
m .%.%.%%%%%%%%%%%.%%%.%%%%%.%.%.%.%.%.%.%.%%%.%%%%%
m .%.%.....%.......%.%.%.....%...%...%.%...%.%.....%
m %%.%%%%%.%.%%%%%%%.%.%.%%%%%%%.%%%%%%%.%%%.%%%%%.%
m .......%...%...%.%...%.......%.%.....%.%.....%...%
m .%%%%%.%%%%%.%.%.%.%%%.%%%%%.%.%.%%%.%.%%%.%%%.%.%
m .....%.%.....%...%.%.%.....%.%...%...%.%...%...%.%
m .%%%.%%%.%%%.%%%%%.%.%%%%%.%.%%%%%%%.%.%.%.%.%%%%%
m ...%.%...%.%.......%.......%.......%.%.%.%.%.....%
m %%%%.%.%%%.%%%%%%%%%.%%%%%%%%%%%%%.%.%.%.%%%%%%%.%
m .....%...%.....%...%.........%.....%.%.%.%...%...%
m .%%%%%%%.%%%.%.%.%.%%%.%%%%%.%.%%%%%.%.%.%.%.%.%%%
m .%.......%...%.%.%...%.%...%.%.%.%...%...%.%.%...%
m .%.%%%%%%%.%%%.%.%%%.%%%.%.%%%.%.%.%%%%%.%.%.%%%.%
m .%.%...%...%.%.%...%.....%...%.%.%.%...%.%.%.....%
m .....%...%.........%...........%.....%.....%....*%
m %%%%%%%%%%%%%%%%%%%%%%%%%%%%%%%%%%%%%%%%%%%%%%%%%%
