rows 20
cols 20
players 0
m %.....%.............
m .%a.%%.........b%%..
m .%%....%%%%%%%%..%%.
m ..%...%%......%...%.
m ..%%..%.......%%....
m ..%%..%.............
m ..%...%.....%....%%.
m ..%...%.%%..%.....%%
m ..%%..%..%%.%......%
m ...%......%.%%....%%
m ....%%...*%..%....%.
m ..%..%%...%..%%.....
m .%%.......%...%%%%..
m %%........%.%....%..
m %.....c..%%.%%..%%..
m %%.%.....%...%%.%...
m .%.%%..%%.....%.....
m f....%%%...d...%....
m .%....e.......%%....
m .%......%%%%%.......
